2,2,2,2,2,2,2,2,2,2,2,2
2,8,1,3,1,0,1,0,1,6,1,2
2,1,4,1,0,1,0,1,5,1,0,2
2,0,1,3,1,0,1,0,1,6,1,2
2,1,4,1,0,1,0,1,5,1,0,2
2,0,1,3,1,0,1,0,1,6,1,2
2,1,4,1,0,1,0,1,5,1,0,2
2,0,1,3,1,0,1,0,1,6,1,2
2,1,4,1,0,1,0,1,5,1,0,2
2,0,1,3,1,0,1,0,1,6,1,2
2,7,4,1,0,1,0,1,5,1,0,2
2,2,2,2,2,2,2,2,2,2,2,2
